aberration	偏差；異常現象
abeyance	中止
abnegate	放棄
abrogate	廢除
abstemious	節制的
abstruse	深奧的
acerbic	尖刻的
acquiesce	默許
acumen	敏銳
admonish	告誡
adroit	機巧的
adulation	諂媚
adumbrate	預示；略微暗示
affable	和藹可親的
alacrity	敏捷；樂意
ameliorate	改善
amorphous	無定形的
anachronism	時代錯誤
anachronistic	時代錯誤的
anathema	詛咒；極討厭的事物
antipathy	反感
apathy	冷漠
apocryphal	虛假的
approbation	認可；讚許
arbiter	裁決者
arrogate	霸佔；冒稱
artless	單純的
ascetic	禁慾的
aspersion	誹謗
assiduous	勤奮的
attenuate	減弱
avarice	貪婪
baleful	惡意的
banal	陳腐的
bane	禍根
bastion	堡壘；堅固據點
beleaguer	圍攻
belie	掩飾
bellicose	好戰的
beneficent	慈善的
blandishment	奉承
bombast	誇大之詞
bombastic	誇大的
boorish	粗野的
brevity	簡潔
brusque	唐突的
bucolic	田園的
burgeon	迅速成長
burnish	擦亮
cacophony	刺耳聲
callow	稚嫩的
calumny	誹謗
camaraderie	同志情誼
candor	坦率
capitulate	投降
capricious	變化無常的
castigation	懲罰
catalyst	催化劑
cathartic	宣洩情緒的
caustic	腐蝕性的；挖苦的
censure	譴責
chicanery	詭計；狡辯
circumspect	謹慎的；慎重的
clemency	寬容
coagulate	凝固
cogent	有說服力的；令人信服的
cogitate	深思
colloquial	口語的
commensurate	相稱的
commiserate	同情
complaisant	彬彬有禮的
concomitant	伴隨的
conflagration	大火
contentious	好爭辯的
contumacious	頑固反抗的
conundrum	難題
convivial	歡樂的
corpulent	肥胖的
corroborate	證實
craven	懦弱的
credence	信任；信念
credulous	輕信的
cupidity	貪婪
daunt	嚇倒
dearth	缺乏
debauch	使墮落
decorous	端莊的
defenestration	拋出窗外
deleterious	有害的
demagogue	煽動者
demur	反對
desiccate	使乾燥
despot	暴君
desultory	散漫的；無計劃的
diaphanous	半透明的
diatribe	謾罵
dichotomy	二分法
dilettante	業餘愛好者
disabuse	糾正（錯誤觀念）
disconsolate	鬱鬱寡歡的
disparage	貶低
disparate	迥然不同的
dissemble	掩飾
dissonance	不和諧
droll	滑稽的
dudgeon	憤怒
ebullience	熱情洋溢
edify	啟發
efface	抹去
effervescent	活潑的；興奮的
efficacious	有效的
effrontery	厚顏無恥
effusive	感情氾濫的
egregious	極壞的
elicit	引出
emollient	潤膚劑
empirical	經驗主義的
emulate	模仿並超越
enervate	使衰弱
engender	產生
ephemeral	短暫的；轉瞬即逝的
epitome	典型
equanimity	鎮靜；平靜
equivocate	含糊其詞
erudite	博學的
eschew	避開
esoteric	深奧的；只有少數人懂的
ethereal	飄渺的
eulogy	頌詞
evanescent	迅速消失的
excoriate	嚴厲批評
exculpate	開脫
execrable	極壞的；令人厭惡的
execrate	憎恨
exegete	詮釋者
exigent	緊急的
expatiate	詳述
facetious	滑稽的
fallacious	謬誤的
farrago	混雜物
fastidious	挑剔的；講究的
fatuous	愚蠢的
fealty	忠誠
feckless	無效的
felicitous	貼切的
fervid	熱情的
flippant	輕浮的
florid	絢麗的
flout	藐視
foment	煽動
fortuitous	偶然的
fractious	易怒的
furtive	偷偷摸摸的
gainsay	否認
garrulous	喋喋不休的
gauche	笨拙的
gibe	嘲弄
grandiloquent	誇張的；浮誇的
grandiose	浮誇的
grandstand	譁眾取寵
gregarious	愛社交的；群居的
guile	狡猾
halcyon	寧靜的
hapless	不幸的
harangue	激烈演說
hedonist	享樂主義者
hegemony	霸權
hermetic	密封的；深奧的
heterodox	異端的
hubris	驕傲
iconoclast	反傳統者
ignominious	可恥的；不名譽的
imbroglio	糾葛
immutable	不可改變的
imperturbable	冷靜的
impetuous	魯莽的
impinge	侵犯
implacable	難平息的
importunate	糾纏不休的
impugn	質疑
impute	歸咎於
incendiary	煽動的
inchoate	初步的；未成熟的
incisive	銳利的
indefatigable	不屈不撓的
indigent	貧窮的
indolent	懶惰的
ineffable	難以言喻的
inept	無能的
inexorable	不可阻擋的
ingenuous	率直的
ingratiate	討好
inimical	不利的；敵意的
inscrutable	難以理解的
insidious	暗中危害的
insipid	無味的；乏味的
insouciant	無憂無慮的
interloper	闖入者
internecine	內鬥的
inure	使習慣於
invective	辱罵
inveterate	根深蒂固的（習慣、偏見等）
invidious	招人怨恨的
jejune	枯燥無味的
jettison	拋棄
jingoistic	沙文主義的
jocular	詼諧的
juxtapose	並列
kismet	命運
knell	喪鐘
lachrymose	愛哭的；催淚的
laconic	簡潔的
languid	倦怠的
lapidary	寶石的；言語精練的
legerdemain	戲法；巧妙手法
levity	輕率
libertine	放蕩者
lucid	清楚的
lucubration	苦學
lurid	駭人的
magnanimous	寬宏大量的；有雅量的
magniloquent	言語誇張的
maladroit	笨拙的
malinger	裝病逃避工作
manifold	多樣的
maudlin	感情脆弱的
maverick	特立獨行者
mellifluous	悅耳動聽的
mendacious	虛假的；捏造的
mendicant	乞丐
meretricious	華而不實的
milieu	社會環境
milquetoast	膽小的人
misanthrope	厭世者
mitigate	減輕
morass	困境
moribund	垂死的
munificence	慷慨
munificent	慷慨的
myopic	短視的
nadir	谷底
nascent	初生的
nefarious	惡毒的
neologism	新詞
noisome	惡臭的
nonchalant	冷淡的
nonplussed	困惑的；不知所措的
noxious	有毒的
obdurate	頑固的；冷酷的
obfuscate	使模糊；使混亂
oblique	斜的；隱晦的
obsequies	葬禮
obsequious	諂媚的；逢迎的
obstreperous	喧鬧的
obtuse	遲鈍的
occlude	封閉
officious	多管閒事的
onerous	繁重的
onus	責任
oppobrium	辱罵
opprobrium	辱罵
ostracize	放逐
palimpsest	重寫本；歷史痕跡
panacea	萬靈藥；解決一切問題的方法
panegyric	頌詞
paragon	模範
pariah	賤民
parsimonious	吝嗇的
parsimony	吝嗇
peccadillo	小過失
pedant	賣弄學問者
pejorative	貶義的
pell-mell	混亂地
pellucid	清澈的
penurious	吝嗇的
perfidious	背信棄義的
perfidy	背信棄義
perfunctory	敷衍的；馬虎的
pernicious	致命的
perspicacious	有洞察力的
phlegmatic	冷靜的；遲鈍的
placate	撫慰
plaintive	哀傷的
precipitate	突然發生的
precocious	早熟的
predilection	偏好
prescient	有先見的
prevaricate	支吾
probity	誠實；正直
prodigal	揮霍的
propriety	得體
prosaic	乏味的
puerile	幼稚的
pugnacious	好鬥的
pulchritude	美貌；（尤指女性的）體態美
quagmire	泥淖；困境
quandary	困境
querulous	愛抱怨的
quibble	吹毛求疵
quiescent	靜止的
quixotic	不切實際的
raillery	逗趣
rancor	怨恨
rarefy	使稀薄
raucous	喧鬧的
recalcitrant	不服從的
reclusive	隱居的
recondite	晦澀的；深奧的
redolent	充滿…氣味的；讓人想起…的
refractory	倔強的
remonstrate	抗議
reprobate	道德敗壞者
repudiate	否認
rescind	撤銷
reticent	沉默的
sacrosanct	神聖不可侵犯的
sagacious	睿智的；有遠見的
salient	顯著的
salubrious	有益健康的
salutary	有益的
sanguine	樂觀的
scurrilous	惡意中傷的
sinecure	閒職
solipsistic	唯我主義的
soporific	催眠的；令人昏昏欲睡的
specious	似是而非的
spurious	偽造的
squalid	骯髒的
stolid	遲鈍的
strident	刺耳的
sublime	崇高的
supercilious	高傲的
tacit	默示的
taciturn	沉默寡言的
tantamount	等同於
tawdry	俗氣的
temerity	魯莽
torpor	遲鈍
transient	短暫的
trenchant	犀利的
truculent	尖酸刻薄的；好鬥的
turbid	混濁的
turpitude	卑鄙；墮落
ubiquitous	無所不在的
ubiquity	普遍存在
umbrage	不悅
unctuous	虛情假意的
unflappable	鎮定的
untenable	站不住腳的
vacillate	動搖
vapid	乏味的
venerable	令人尊敬的
venerate	尊敬
veracity	誠實
verbose	囉嗦的
verdant	青翠的
verisimilitude	逼真
vex	使惱火
vicissitude	變遷；興衰
visceral	內心的；本能的
vituperative	謾罵的；責罵的
vociferous	喧嚷的；大聲疾呼的
volatile	易變的
voluble	健談的
wane	衰退
waver	猶豫
wheedle	哄騙
winsome	迷人的
wizened	乾瘦的
xenophobia	排外主義
yearn	渴望
yokel	鄉巴佬
zeal	熱情
zealot	狂熱者
zephyr	微風
